{
"level":
 [
	[
		[0, 0, 0, 0, 0, 0, 0, 0, 0, 0, 0],
		[0, 1, 1, 1, 0, 0, 0, 0, 0, 0, 0],
		[0, 1, 0, 1, 0, 0, 0, 0, 0, 0, 0],
		[0, 1, 1, 1, 1, 1, 1, 0, 0, 0, 0],
		[0, 0, 0, 0, 0, 0, 1, 1, 0, 0, 0],
		[0, 0, 0, 0, 0, 0, 0, 1, 1, 0, 0],
		[0, 1, 0, 0, 0, 1, 0, 1, 1, 0, 0],
		[0, 1, 0, 0, 0, 1, 0, 0, 0, 0, 1],
		[1, 1, 1, 0, 0, 1, 0, 0, 0, 0, 1],
		[1, 0, 1, 0, 1, 1, 1, 0, 0, 0, 1],
		[1, 0, 1, 0, 0, 0, 0, 0, 0, 0, 1],
		[1, 1, 1, 0, 0, 0, 0, 0, 0, 1, 1]
	],
	[
		[1, 1, 1, 0, 0, 0, 0, 1, 1, 1, 1],
		[1, 0, 1, 0, 0, 0, 0, 1, 0, 0, 1],
		[1, 0, 1, 0, 0, 0, 0, 1, 0, 0, 1],
		[1, 0, 1, 0, 0, 0, 0, 1, 1, 1, 1],
		[1, 1, 1, 0, 0, 0, 0, 0, 0, 0, 0],
		[1, 0, 1, 0, 0, 0, 0, 0, 0, 0, 0],
		[1, 0, 1, 0, 0, 0, 0, 0, 0, 0, 0],
		[1, 1, 1, 0, 0, 0, 0, 0, 0, 0, 0],
		[0, 0, 0, 0, 0, 0, 0, 0, 0, 0, 0],
		[0, 0, 0, 0, 0, 0, 0, 0, 0, 0, 0],
		[0, 0, 0, 0, 1, 0, 0, 1, 0, 1, 1],
		[0, 0, 0, 1, 1, 1, 1, 1, 1, 1, 0]
	],
	[
		[0, 0, 0, 0, 0, 0, 0, 0, 0, 0, 0],
		[0, 0, 0, 0, 0, 0, 0, 0, 0, 0, 0],
		[0, 0, 0, 0, 0, 0, 0, 0, 0, 0, 0],
		[0, 0, 0, 0, 0, 0, 0, 1, 1, 1, 0],
		[0, 0, 0, 0, 0, 0, 0, 0, 0, 1, 0],
		[0, 0, 0, 0, 0, 0, 0, 0, 0, 1, 0],
		[0, 0, 0, 0, 1, 1, 1, 1, 0, 1, 0],
		[0, 0, 0, 0, 1, 0, 0, 0, 0, 1, 0],
		[0, 0, 0, 0, 1, 0, 0, 0, 0, 1, 1],
		[0, 0, 0, 0, 1, 0, 1, 1, 0, 0, 0],
		[0, 0, 0, 0, 0, 0, 0, 1, 0, 0, 0],
		[0, 0, 0, 0, 0, 0, 1, 1, 0, 0, 0]
	]
 ],
 "start": [0, 11, 1],
 "goal": [1, 0, 11],
 "enemies": [
 	{
		"type": "Bounce",
		"layer": 1,
		"path": [[11, 3], [11, 4], [11, 5], [11, 6], [11, 7], [11, 8], [11, 9],
		[11, 10], [10, 10], [10, 11]]
	},
 	{
		"type": "Loop",
		"layer": 0,
		"path": [[1, 1], [1, 2], [1, 3], [2, 3], [3, 3], [2, 3], [1, 3], [1, 2]]
	}
 	]
 }
}
