{
    "level":
    [
        [
            [0, 0, 0, 0, 1, 1, 1, 1, 1],
            [0, 0, 0, 0, 0, 0, 0, 0, 1],
            [0, 0, 0, 0, 0, 0, 0, 0, 1],
            [1, 1, 1, 1, 1, 1, 0, 0, 1],
            [0, 0, 0, 0, 0, 0, 0, 0, 1],
            [0, 0, 0, 0, 0, 0, 0, 0, 1],
            [0, 0, 0, 1, 0, 0, 0, 0, 1],
            [0, 0, 0, 1, 1, 1, 1, 1, 1]
        ],
        [
            [0, 0, 0, 0, 0, 0, 0, 0, 0],
            [0, 0, 1, 1, 1, 1, 1, 1, 0],
            [0, 0, 1, 0, 0, 0, 0, 1, 0],
            [0, 0, 0, 0, 0, 1, 0, 1, 0],
            [0, 1, 1, 1, 1, 1, 0, 1, 0],
            [0, 0, 0, 0, 0, 0, 0, 1, 0],
            [0, 0, 0, 1, 1, 1, 1, 1, 0],
            [0, 0, 0, 0, 0, 0, 0, 0, 0]
        ],
        [
            [0, 0, 0, 0, 0, 0, 0, 0, 0],
            [0, 0, 0, 0, 0, 0, 0, 0, 0],
            [0, 0, 1, 1, 1, 1, 1, 0, 0],
            [0, 0, 0, 0, 0, 0, 1, 0, 0],
            [0, 1, 0, 0, 0, 0, 1, 0, 0],
            [0, 1, 1, 1, 1, 1, 1, 0, 0],
            [0, 0, 0, 0, 0, 0, 0, 0, 0],
            [0, 0, 0, 0, 0, 0, 0, 0, 0]
        ]
    ],
    "coins": 15,
    "start": [0, 3, 0],
    "startRotation": "DOWN",
    "name": "Time was running short.",
    "goal": [0, 0, 4],
    "enemies":
    [
        {
            "type": "Loop",
            "layer": 1,
            "path":
            [
                [2, 5], [2, 6], [2, 7], [2, 8]
            ]
        },
        {
            "type": "Loop",
            "layer": 1,
            "path":
            [
                [4, 8], [4, 5], [4, 6], [4, 7]
            ]
        },
        {
            "type": "Bounce",
            "layer": 1,
            "path":
            [
                [3, 4], [3, 5], [3, 6], [3, 7], [3, 8]
            ]
        }
    ]
}
